1111111
1PE0001
1000C11
1111111
