11111111111111111111
1P010C10000C1000C1C1
10100111111000111101
10101110000C11C00001
101C11C0011110111101
1000000000000000C001
11111111011111111011
1E00000001C000000011
11111111111111111111