11111111111111111111111111111
100C1P1C0011C0001111C10000E11
101110110011111C0000010000001
101C0000001C00111011110011111
10111111101110100000000010001
10000C10001C00000100001110001
10011110001C00111101100C10011
100100100111111C000C1111101C1
1001C0100000000111001C0010101
1001000011111000C100111010101
10011110111111111100100010101
1000C0000C0000000000000000001
11111111111111111111111111111